





                          #################################
                          #                               #
                          #     @                         #
                          #                               #
                          #              >                #
                          #                               #
                          #                               #
                          #                               #
                          #                               #
                          #                               #						  
						  #################################